.........#.#.........
.........#.#.........
.........#.#.........
.........#.#.........
.........#.#.........
.........#...........
.........#...........
......########.......
~#~#~##..@@@...#~#~#~
.........@@@.........
.........@@@.........
#~#~#~#..@@@..#~#~#~#
......####.####......
.........~.~.........
...........#.........
.......~~#.#.........
.......~~#.#.........
.....~~~~#.#.........
.....~~~~#.#.........
.....................
